#ChatExtra 傾計專用ExtraCommand
#bang	叫你唔好warn你就去ban 都話一家人咯 你都係一槍打死自己算啦 💥 💥
#Ben	大家都是好同學
#Cheong	小毒毒你行開，我係大毒毒
#eathw	功課咩呢Ga,食唔食得ga
#eevee	伊貝永遠係Anson既💕💕😍
#FP	都講你Face Problem 啊XD 
#groupmembers	請友善對代本群訓練員
#HongKong	公告：本群係香港的pokemon狼人group，由於我們都是因為尊重香港文化而決定建立呢個grorp，文字中有好多香港特色，希望大家可以尊重返香港的文化~我們用的係廣東話、繁體字
#Huiman	kayu點會係娘娘？🙄明明就係一隻豬🙈我先係真娘娘👋
#hwtg	好似味道唔差？😂
#iamnew	唔好嘈，我最新
#ida	花哥哥幾時包養我啊😍😍😍😍😍💑💑
#Kri 我係 the queen of 抽水command
#kayu2	我只愛自己大家想多了。
#AK	Anson❤️Kayu😂😂大家唔好殺kayu la☺️☺️
#AnsonKayu	邊個夠膽殺我媽子 我Anson絕對唔會放過佢😤😤💕
#AnsonKayu2	請大家唔好FB\FV Anson/Kayu 我地要互殺😂
#Katherine2	本方丈呢排sem尾好Q燥底，再fb fv我，我真係會退群，我退群就冇人可以留到我，我一走以後冇活動唔好問點解，講完
#kayuunotgirlgod	夠啦唔好再話我係娘娘啦 我係Anson個娘親😂👋
#kayuuu	姐姐我係娘娘 但我為人低調 絕對唔會同你班庶民講💕😏
#kriwater	想玩抽水command 初體驗mou?
#leungleung	參見娘娘
#Li1	佢叫弱智
#LouiSM	全都怪我 不該沉默時沉默
#love	我永遠係到感受到滿滿的愛😍😍😍😍
#luck	點解我們沒有運氣！！！😁😁😁😁
#nohwpls	我好唔想做功課啊！😢😭
#nosorsiuowo	大家放條生路俾佢啦 雖然佢又毒又寸 但係佢都想有得認真玩落去 短時間內唔好再FBFV佢啦😂😂
#Oddy2	我知腦袋很珍貴，人人都應該擁有，但我家貧，所以賣咗
#siutoktok	請大家善待本群小毒毒。
#Sorsiuowo	其實我真係一D都唔毒，大家要好好善待我。
#sorsiuowo	我一日半就搞29隻，你哋仲未ok？好明顯你哋唔夠我毒！
#sorsiuowo2	你真係覺得有人毒得過你？
#sorsiuowo3	如果我係小毒毒，咁冇人係毒。其實我呢d唔叫毒，叫生活。
#tok	比毒毒大賽來la😂
#tree	有棵咁既樹(有D咁既事）??
#warm	Admin都係一家人唔好warn啦 溫暖啲啦😍💕
#whycantI	我都係超(低)能系喎！
